0:32:32
-2:3
1:32:304:1
1:256:448:1
1:272:272:1
1:192:32:1
1:736:32:1
1:752:408:1